28 31 30 29 29 32 27 32 34 28 28 27 27 30 34 28 28 31 29 29 32 34 30 32 32 29 29 28 32 30 31 28 29 29 29 30 32 32 27 28 30 29 28 28 31 28 27 32 29 29 
31 36 37 37 37 37 37 37 37 37 37 37 37 33 37 37 37 36 37 37 37 37 37 37 37 37 37 37 37 37 36 37 37 37 37 37 37 37 37 37 37 37 37 37 37 37 37 37 33 29 
32 37 37 37 37 37 37 37 37 37 37 37 37 37 37 37 37 37 37 37 37 37 37 37 37 37 37 37 37 37 37 37 37 37 37 37 37 37 37 37 37 37 37 37 37 37 37 37 37 32 
34 37 37 37 37 37 37 37 37 37 37 37 37 37 37 37 37 37 37 37 37 37 37 37 37 37 37 37 37 37 37 37 37 37 37 37 37 37 37 37 37 37 37 37 37 37 37 37 37 27 
34 37 37 37 37 37 37 37 37 37 37 37 37 37 37 37 37 37 37 37 37 37 37 37 37 37 37 37 37 37 31 31 37 37 37 37 37 37 37 37 37 37 37 37 37 37 37 37 37 28 
31 37 37 37 37 37 37 37 37 37 37 37 37 35 37 37 28 28 37 37 37 37 0 1 1 1 1 1 1 1 2 31 37 37 37 37 37 37 37 37 37 37 37 37 37 37 37 37 36 31 
32 37 37 37 37 37 37 9 10 10 10 10 10 10 10 10 11 28 37 37 37 37 3 4 4 4 4 4 4 4 5 29 37 37 37 37 37 37 37 37 37 37 37 37 37 37 37 37 37 31 
31 37 37 37 37 37 37 12 13 13 13 13 13 13 13 13 14 36 37 37 37 29 3 4 4 4 4 4 4 4 5 37 37 37 37 37 37 37 37 37 37 37 37 37 37 37 37 37 37 28 
28 37 37 37 37 37 37 12 13 13 13 13 13 13 13 13 14 37 37 37 35 29 3 4 4 4 4 4 4 4 5 37 37 37 37 37 37 37 37 37 37 37 37 37 37 37 37 37 37 30 
31 37 37 37 37 37 37 12 13 13 13 13 13 13 13 13 14 37 37 37 37 31 6 7 7 7 7 7 7 7 8 37 37 37 37 37 37 37 37 37 37 37 37 37 37 37 37 37 37 31 
29 37 37 37 37 37 37 12 13 13 13 13 13 13 13 13 14 37 37 37 37 37 37 37 37 37 37 37 37 37 37 37 37 37 37 37 37 37 37 37 37 37 37 37 37 37 37 37 37 29 
30 37 37 35 37 37 28 15 16 16 16 16 16 16 16 16 17 37 37 37 37 37 37 37 37 37 37 37 37 37 37 37 37 37 37 37 37 37 37 37 37 37 37 37 37 37 37 37 37 32 
32 37 37 37 37 37 28 28 36 37 37 37 37 37 37 37 37 37 37 37 37 37 37 37 37 37 37 37 37 37 37 37 37 37 37 37 37 37 37 35 37 37 37 37 37 37 37 37 37 32 
31 37 37 37 37 37 37 37 37 37 37 37 37 37 37 37 37 37 37 37 37 37 37 37 37 37 37 37 37 37 37 37 37 37 35 32 34 31 37 37 37 37 37 37 37 32 32 37 37 27 
31 37 37 37 37 37 37 37 37 37 37 37 37 37 37 37 37 37 37 37 37 37 37 37 37 37 37 37 37 37 37 37 37 37 37 32 18 19 19 19 19 19 19 19 19 20 32 37 37 31 
28 36 37 37 37 37 37 37 37 37 37 37 37 37 37 37 37 37 37 37 37 37 37 37 37 37 37 37 37 37 37 37 37 37 37 37 21 22 22 22 22 22 22 22 22 23 34 37 37 31 
28 37 37 31 30 36 37 37 37 37 37 37 37 37 35 37 37 37 37 37 37 37 37 37 37 37 37 37 37 37 37 37 37 37 37 37 21 22 22 22 22 22 22 22 22 23 37 37 37 28 
31 37 37 31 0 1 1 1 1 1 1 1 2 37 37 37 37 37 37 37 37 37 37 37 37 37 37 37 37 37 37 37 37 37 37 37 21 22 22 22 22 22 22 22 22 23 35 37 37 31 
28 37 37 30 3 4 4 4 4 4 4 4 5 37 37 37 37 37 37 37 37 37 37 37 37 37 37 37 37 37 37 37 37 37 37 37 24 25 25 25 25 25 25 25 25 26 31 37 37 28 
31 37 37 37 3 4 4 4 4 4 4 4 5 37 37 37 37 37 37 37 37 37 37 37 37 37 37 37 37 37 37 37 37 37 37 37 37 37 37 37 37 37 37 37 37 31 31 37 37 31 
32 37 37 37 3 4 4 4 4 4 4 4 5 37 37 37 37 37 37 37 37 37 37 37 37 37 37 37 37 37 37 37 37 37 37 37 37 37 37 37 37 37 37 35 37 37 37 37 37 32 
30 37 37 37 6 7 7 7 7 7 7 7 8 37 37 37 37 37 28 28 35 37 37 37 37 37 37 37 37 37 35 31 31 37 37 37 37 37 37 37 37 37 37 37 37 37 37 37 37 32 
32 37 37 37 37 37 37 37 31 31 36 37 37 37 37 37 37 37 28 9 10 10 10 10 10 10 10 10 10 10 10 11 31 37 37 37 37 37 37 37 37 37 37 37 37 37 37 37 37 27 
29 37 37 37 37 37 37 37 37 37 37 37 37 37 37 37 37 37 34 12 13 13 13 13 13 13 13 13 13 13 13 14 27 37 37 37 37 37 37 37 37 37 37 37 37 37 37 37 33 29 
29 37 37 37 37 37 37 37 37 37 37 37 37 37 37 37 37 37 37 12 13 13 13 13 13 13 13 13 13 13 13 14 37 37 37 37 37 37 37 37 37 37 37 37 37 37 37 37 37 29 
31 37 37 37 37 37 37 37 37 37 37 37 37 37 37 37 37 37 37 12 13 13 13 13 13 13 13 13 13 13 13 14 37 37 37 37 37 37 37 37 37 37 37 37 37 37 37 37 37 34 
31 37 37 37 37 37 37 37 37 37 37 37 37 37 37 37 37 37 37 12 13 13 13 13 13 13 13 13 13 13 13 14 37 37 37 37 37 37 37 37 37 37 37 37 37 37 37 37 37 30 
28 37 37 37 37 37 37 37 37 37 37 37 37 37 37 37 37 37 37 12 13 13 13 13 13 13 13 13 13 13 13 14 34 37 37 37 37 37 37 37 37 37 37 37 37 37 37 37 37 29 
28 37 37 37 37 37 37 37 35 37 37 37 37 37 37 37 37 37 32 15 16 16 16 16 16 16 16 16 16 16 16 17 29 37 37 37 37 37 37 37 37 37 37 37 37 37 37 37 37 32 
34 37 37 37 37 37 37 37 37 37 37 37 37 37 37 37 37 37 32 32 27 37 37 37 37 37 37 37 37 37 35 29 29 37 37 37 37 37 37 37 37 37 37 37 37 37 30 31 37 31 
30 37 37 37 37 37 37 37 37 37 37 37 37 37 37 37 37 37 37 37 37 37 37 37 37 37 37 37 37 37 37 37 37 37 37 37 37 37 37 0 1 1 1 1 1 1 2 37 37 31 
32 37 37 37 37 37 37 37 37 37 37 37 37 37 37 37 37 37 37 37 37 37 37 37 37 37 37 37 37 37 37 37 37 37 37 37 37 37 37 3 4 4 4 4 4 4 5 37 36 28 
29 37 37 37 37 37 37 37 37 36 36 37 37 37 37 37 37 37 37 37 37 37 37 37 37 37 37 37 37 37 37 37 37 37 37 37 37 37 37 3 4 4 4 4 4 4 5 37 37 28 
31 37 37 37 37 37 37 37 37 28 9 10 10 10 10 10 10 10 10 11 31 37 37 37 37 37 37 37 37 37 37 37 37 37 37 37 37 37 31 3 4 4 4 4 4 4 5 37 37 31 
28 37 37 37 37 37 37 37 37 37 12 13 13 13 13 13 13 13 13 14 28 37 37 37 37 37 37 37 37 37 35 37 37 37 37 37 37 37 34 6 7 7 7 7 7 7 8 37 37 34 
30 37 37 37 37 37 37 37 37 37 12 13 13 13 13 13 13 13 13 14 37 37 37 37 37 37 37 37 37 37 37 37 37 37 37 37 37 37 37 37 37 37 37 34 31 31 37 35 37 29 
34 37 37 37 37 37 37 37 37 37 12 13 13 13 13 13 13 13 13 14 37 37 37 37 37 37 37 37 37 37 37 37 37 37 37 37 37 37 37 37 37 37 37 37 37 37 37 37 37 29 
28 33 37 37 37 37 37 37 37 37 12 13 13 13 13 13 13 13 13 14 37 37 37 37 37 37 37 37 37 37 37 37 37 37 37 37 37 37 37 37 37 37 37 37 37 37 37 37 37 31 
27 37 37 37 37 37 37 37 37 31 15 16 16 16 16 16 16 16 16 17 37 37 35 34 37 37 37 37 37 37 37 37 37 37 37 37 37 37 37 37 37 37 37 37 37 37 37 37 37 28 
30 37 37 37 37 37 37 37 37 31 31 28 37 37 37 37 37 37 37 37 37 37 37 37 37 37 37 37 37 37 37 37 37 37 37 37 37 37 37 37 37 37 37 37 37 37 37 37 37 31 
31 37 37 37 37 37 37 37 37 37 37 37 37 37 37 37 37 37 37 37 37 37 37 37 37 37 37 37 37 37 37 37 37 37 37 37 37 37 37 37 37 37 37 37 37 37 37 37 37 32 
32 37 37 37 37 37 37 37 37 37 37 34 37 37 37 37 37 37 37 37 37 37 37 37 37 37 37 37 37 37 37 37 37 37 37 37 37 37 37 37 37 35 37 29 31 32 32 37 37 34 
32 37 37 37 37 18 19 19 19 19 19 19 20 37 37 37 37 37 37 37 37 37 37 37 37 37 37 37 37 37 37 37 37 37 37 37 18 19 19 19 19 19 19 19 19 20 32 37 37 28 
34 37 37 37 34 21 22 22 22 22 22 22 23 37 37 37 37 37 37 37 37 37 37 37 37 37 37 37 37 37 37 37 37 37 37 37 21 22 22 22 22 22 22 22 22 23 30 37 37 32 
30 37 37 37 37 21 22 22 22 22 22 22 23 35 37 37 37 37 37 37 37 37 37 37 37 37 37 37 37 37 37 37 37 37 37 37 21 22 22 22 22 22 22 22 22 23 37 37 37 28 
29 37 37 37 37 24 25 25 25 25 25 25 26 32 37 37 37 37 37 37 37 37 37 37 37 37 37 37 37 37 37 37 37 37 37 29 21 22 22 22 22 22 22 22 22 23 37 37 37 29 
29 37 37 37 37 32 31 31 37 37 37 37 32 31 37 37 37 37 37 37 35 37 37 37 37 37 37 37 37 37 37 37 37 37 37 32 24 25 25 25 25 25 25 25 25 26 37 37 36 31 
27 37 37 37 37 37 37 37 37 37 37 37 37 37 37 37 37 37 37 37 37 37 37 37 37 37 37 37 37 37 37 37 37 37 37 37 37 37 37 37 37 37 37 37 37 37 37 37 37 28 
28 37 37 37 36 37 37 37 37 37 37 37 33 37 37 37 37 37 37 37 37 37 37 37 36 37 37 37 37 37 37 37 37 37 37 37 37 37 37 37 37 37 37 37 36 37 37 37 37 32 
28 32 32 30 31 30 32 29 28 28 34 27 28 30 32 31 32 31 32 29 28 32 34 27 28 28 32 31 27 29 28 34 29 28 29 32 31 30 30 27 29 29 32 29 31 31 28 27 32 31 
