3 3 3 1 2 2 5 5 4 4 6 6 2 1 6 2 6 5 6 1 5 3 5 5 6 2 7 7 6 3 6 1 7 5 7 5 9 6 3 1 2 6 3 9 1 5 7 6 6 3 
2 10 10 10 10 10 10 10 10 10 10 10 10 10 10 10 10 10 10 10 10 10 10 10 10 10 10 10 10 10 10 10 10 10 10 10 10 10 10 10 10 10 10 10 10 10 10 10 10 1 
3 10 10 10 10 10 10 10 10 10 10 10 10 10 10 10 10 10 10 0 0 0 10 10 10 10 10 10 10 10 10 10 10 10 10 10 10 10 10 10 10 10 10 10 10 10 10 10 10 7 
3 10 10 10 10 10 10 10 8 7 10 10 2 10 10 10 10 10 0 0 0 0 0 10 10 10 10 10 10 10 1 10 10 10 10 10 10 10 10 10 10 10 10 10 10 10 10 10 10 5 
4 10 10 10 10 10 10 0 0 0 0 0 10 9 10 10 10 10 10 0 0 0 10 7 10 10 10 10 10 10 0 0 0 0 0 0 0 0 0 0 0 0 10 10 10 10 10 10 10 2 
6 10 10 10 10 6 0 0 0 0 0 0 0 10 10 10 10 10 10 10 10 8 10 10 10 10 10 9 10 0 0 0 0 0 0 0 0 0 0 0 0 0 0 10 10 10 10 8 10 1 
5 10 10 10 10 10 10 0 0 0 0 0 10 10 10 10 10 10 10 10 10 10 10 10 10 10 10 2 0 0 0 0 0 0 0 0 0 0 0 0 0 0 0 0 10 10 10 10 10 4 
5 10 10 10 10 10 10 2 2 5 10 10 10 10 10 10 10 10 10 10 10 10 10 10 10 10 10 10 0 0 0 0 0 0 0 0 0 0 0 0 0 0 0 0 3 10 10 10 10 3 
4 10 10 10 10 10 10 5 4 5 10 10 10 10 10 10 10 10 10 10 5 2 5 2 10 10 10 10 0 0 0 0 0 0 0 0 0 0 0 0 0 0 0 0 5 10 10 10 10 5 
2 10 10 10 10 10 10 10 10 10 10 10 10 10 10 10 10 10 10 10 2 2 4 2 10 10 10 10 0 0 0 0 0 0 0 0 0 0 0 0 0 0 0 0 10 10 10 10 10 5 
3 10 10 10 10 10 10 10 10 10 10 10 10 10 10 10 10 10 10 10 10 10 10 10 10 10 10 10 0 0 0 0 0 0 0 0 0 0 0 0 0 0 0 0 10 10 10 10 10 2 
5 10 10 10 10 10 10 10 10 10 10 10 10 10 7 8 10 10 10 10 10 10 10 6 6 6 10 10 10 0 0 0 0 0 0 0 0 0 0 0 0 0 0 10 10 10 10 10 10 6 
3 10 10 10 10 10 10 10 10 10 2 2 5 10 10 10 10 10 10 10 10 10 10 3 3 4 10 10 10 10 0 0 0 0 0 0 0 0 0 0 0 0 10 10 10 10 10 10 10 3 
6 10 10 10 10 7 7 4 10 10 2 2 9 10 10 10 10 10 10 10 10 10 10 10 10 10 10 10 5 10 3 3 6 10 10 10 10 10 3 10 10 3 6 10 10 10 10 10 10 1 
1 10 10 10 8 4 7 4 10 10 10 10 10 10 10 10 10 10 10 10 10 10 10 10 10 10 10 10 10 10 10 10 10 10 10 10 10 10 10 10 10 10 10 10 10 10 10 10 10 5 
6 10 10 10 10 10 10 10 10 10 10 0 0 0 0 0 0 0 0 0 0 0 0 0 0 10 10 10 10 10 10 10 10 10 10 10 10 10 10 10 10 10 10 10 10 10 10 10 10 7 
5 10 10 10 10 10 10 10 10 10 0 0 0 0 0 0 0 0 0 0 0 0 0 0 0 0 10 10 10 10 10 10 10 10 10 10 10 10 10 10 10 10 10 10 10 10 10 8 10 5 
3 10 10 10 10 10 10 10 10 10 0 0 0 0 0 0 0 0 0 0 0 0 0 0 0 0 10 10 10 10 10 10 10 10 10 10 10 10 10 10 10 10 10 10 10 10 10 10 10 2 
1 10 10 10 9 2 10 10 10 10 0 0 0 0 0 0 0 0 0 0 0 0 0 0 0 0 10 10 10 10 10 10 10 10 10 10 10 9 10 10 10 10 10 10 10 10 10 10 10 6 
3 10 10 10 10 10 10 10 10 10 0 0 0 0 0 0 0 0 0 0 0 0 0 0 0 0 10 10 10 10 10 10 10 10 10 10 10 10 2 2 4 5 10 10 10 10 10 10 10 2 
1 10 10 10 4 2 10 10 10 10 0 0 0 0 0 0 0 0 0 0 0 0 0 0 0 0 10 10 10 10 10 10 10 10 10 10 10 10 5 4 2 2 9 10 10 10 10 10 10 2 
5 10 10 10 2 2 10 10 10 10 0 0 0 0 0 0 0 0 0 0 0 0 0 0 0 0 10 10 10 10 10 10 10 10 10 10 10 10 10 10 10 10 10 10 10 10 10 10 10 2 
6 10 10 10 2 4 10 10 10 10 0 0 0 0 0 0 0 0 0 0 0 0 0 0 0 0 10 10 10 10 10 10 10 10 10 10 10 10 10 10 10 10 10 10 10 10 10 10 10 3 
5 10 10 10 10 10 10 10 10 10 10 0 0 0 0 0 0 0 0 0 0 0 0 0 0 10 10 10 10 10 10 10 10 10 10 10 10 10 10 10 10 10 10 10 10 10 10 10 10 3 
3 10 10 10 10 10 10 10 10 10 10 10 10 10 10 10 10 10 10 10 10 10 10 10 10 10 10 10 10 10 8 10 10 10 10 10 10 10 10 10 10 10 10 10 10 10 10 10 10 1 
1 10 10 10 10 10 10 10 10 10 10 10 10 5 5 5 4 4 10 10 10 10 10 10 10 10 7 7 8 10 10 10 10 10 10 10 10 10 10 10 10 10 10 10 10 10 10 10 10 1 
2 10 10 10 10 10 10 10 10 10 10 10 10 4 4 6 6 6 10 10 10 10 10 10 10 7 7 7 10 10 10 10 10 10 10 10 10 10 10 10 10 10 10 10 10 10 10 10 10 5 
2 10 10 10 10 10 10 10 10 10 10 10 10 10 10 10 10 10 10 10 10 10 10 10 10 7 7 10 10 10 10 10 10 10 10 10 10 10 10 10 10 10 10 10 10 10 10 10 10 6 
5 10 10 10 10 10 10 10 10 10 10 10 10 10 10 10 10 10 10 10 10 10 10 10 8 10 10 10 10 10 10 10 10 10 10 6 3 3 10 10 10 10 10 10 10 10 10 10 10 6 
5 10 10 10 10 10 10 10 10 5 5 4 7 10 10 10 10 10 10 10 10 10 10 10 10 10 10 10 10 10 10 10 10 10 10 6 6 3 10 10 10 10 10 10 10 10 10 10 10 5 
2 10 10 10 10 10 10 10 1 4 5 5 10 10 8 10 10 10 10 10 10 10 10 10 10 10 10 10 10 10 10 10 10 10 10 10 10 10 10 10 10 10 10 10 10 10 10 10 10 3 
3 10 10 10 10 10 10 10 10 10 10 10 10 10 10 10 10 10 10 10 10 10 10 10 10 10 10 10 10 10 10 10 10 10 10 10 10 10 10 10 10 10 10 10 10 10 10 10 10 3 
5 10 10 10 10 10 10 10 10 10 10 10 10 10 10 10 10 10 10 10 10 10 10 10 10 10 10 10 0 0 0 0 0 0 0 0 0 0 0 0 10 10 10 10 10 10 10 10 10 4 
3 10 10 10 10 10 10 10 10 10 10 10 10 10 10 10 10 10 10 10 10 10 10 10 10 10 10 0 0 0 0 0 0 0 0 0 0 0 0 0 0 10 10 10 10 10 10 10 10 3 
2 10 10 10 10 10 10 10 10 10 10 10 2 2 4 2 10 10 10 10 10 10 10 10 10 10 0 0 0 0 0 0 0 0 0 0 0 0 0 0 0 0 10 10 10 10 10 10 10 6 
5 10 10 10 10 10 10 10 0 10 10 10 4 2 4 2 10 10 10 10 10 10 10 10 10 10 0 0 0 0 0 0 0 0 0 0 0 0 0 0 0 0 10 10 10 10 10 10 10 5
3 10 10 10 10 10 10 0 0 0 10 10 10 10 10 10 10 10 10 10 10 10 10 10 10 10 0 0 0 0 0 0 0 0 0 0 0 0 0 0 0 0 10 10 10 10 10 10 10 2
3 10 10 10 10 10 0 0 0 0 0 10 10 10 10 10 10 10 10 10 10 10 10 10 10 10 0 0 0 0 0 0 0 0 0 0 0 0 0 0 0 0 10 10 10 10 10 10 10 2 
5 10 10 10 10 0 0 0 0 0 0 0 9 10 10 4 4 10 10 10 10 10 10 10 10 10 0 0 0 0 0 0 0 0 0 0 0 0 0 0 0 0 10 10 10 10 10 10 10 6 
2 10 10 10 0 0 0 0 0 0 0 0 0 10 10 9 4 10 10 10 10 10 10 10 10 10 10 0 0 0 0 0 0 0 0 0 0 0 0 0 0 10 10 10 10 10 10 10 10 3 
3 10 10 0 0 0 0 0 0 0 0 0 0 0 10 10 10 10 10 10 10 10 10 10 10 10 10 10 0 0 0 0 0 0 0 0 0 0 0 0 10 10 10 10 10 10 10 10 10 5 
5 10 10 10 0 0 0 0 0 0 0 0 0 10 10 10 10 10 10 10 10 10 10 10 10 10 10 10 10 10 10 10 10 10 10 10 10 10 10 10 10 10 10 10 10 10 10 10 10 5 
6 10 10 10 10 0 0 0 0 0 0 0 10 10 10 10 10 10 10 10 10 10 10 10 10 10 10 10 10 10 10 10 10 10 10 10 10 10 10 10 10 10 10 10 10 10 10 10 10 2 
4 10 10 10 10 10 0 0 0 0 0 10 10 10 10 10 10 10 7 7 4 10 10 10 10 10 10 10 10 10 10 10 10 10 10 10 10 10 10 10 10 10 10 10 10 10 10 10 10 4 
6 10 10 10 10 10 10 0 0 0 10 10 10 10 10 10 10 10 8 7 4 10 10 10 10 10 10 10 10 10 10 10 3 3 4 3 10 10 10 3 4 3 3 10 10 10 10 10 10 2 
5 10 10 10 10 10 10 10 0 10 10 10 10 10 10 10 10 10 10 10 10 10 10 10 10 10 10 10 10 10 10 10 3 3 3 5 10 10 10 4 3 4 3 10 10 10 10 10 10 9 
7 10 10 10 10 10 10 10 10 7 7 10 10 10 10 10 10 10 10 10 10 10 10 10 10 10 10 10 10 10 10 10 10 10 10 10 10 10 10 10 10 10 10 10 10 10 10 10 10 1 
1 10 10 10 10 10 10 10 10 8 7 10 10 10 10 10 10 10 10 10 10 10 10 10 10 10 10 10 10 10 10 10 10 10 10 10 10 10 10 10 10 10 10 10 10 10 10 10 10 5 
3 10 10 10 10 10 10 10 10 10 10 10 10 10 10 10 10 10 10 10 10 10 10 10 10 10 10 10 10 10 10 10 10 10 10 10 10 10 10 10 10 10 10 10 10 10 10 10 10 4 
4 1 7 4 3 2 6 5 6 7 1 3 2 6 1 6 3 5 6 7 5 1 2 2 6 6 1 3 2 1 5 7 4 5 3 6 6 5 5 3 7 7 6 1 2 2 5 7 9 6